SO textures/Prototype/South.xpm
WE textures/Prototype/West.xpm
EA textures/Prototype/East.xpm
NO textures/Prototype/North.xpm
C 232,66,37
F 30,230,113


 111111111111111
110E0000000010001
 1011111111110111
100000011100001        
11111100111011111
1   10000110011 111
1  111001 1000111
 1100001   11001
1000101     1101
1011101   111101
1001001  1000101
 10101   1011101
 100111111011101
  10000000000001
   111111111111
