SO textures/Prototype/South.xpm
WE textures/Prototype/West.xpm
EA textures/Prototype/East.xpm
NO textures/Prototype/North.xpm
C 232,66,37
F 30,230,113

11111111111111111
100E0000000000001
11111111111111111
