
WE prout
SO xd

EA ./path_to_the_east_texture
NO ./path_to_the_north_texture    

C 5,255,55
F 220,100,0



11111111111
11111000001
100011100111111111
1110E1 111000000001   
111101111111111111
11111111111