
SO xd
WE prout
EA ./path_to_the_east_texture
NO ./path_to_the_north_texture    
C 2,255,55
F 220,100,0


11111111111
11111000001
100011100111111111
111001 11100000001   
11110N1111111111111
11111111111