SO ./path_to_the_south_texture
NO ./path_to_the_north_textureaaaa
WE ./path_to_the_west_texture
EA ./path_to_the_east_texture

F 220,100,0
C 225,30,0


   111111111
111100000001
101000000011
1101N1000001
111111111111
