
SO xd
WE prout
EA ./path_to_the_east_texture
NO ./path_to_the_north_texture    
C 2,255,55
F 220,100,0


111111
110011
100001
10E001
100001
111111