SO ./path_to_the_south_texture
NO ./path_to_the_north_textureaaaa
WE ./path_to_the_west_texture
EA ./path_to_the_east_texture

C 225,305,5
F 220,100,0


111111
100101
101001
11001
11111
1
10001
