SO ./path_to_the_south_texture
WE ./path_to_the_west_texture
EA./path_to_the_east_texture
NO ./path_to_the_north_texture

C 225,250,5
F 220,100,0

111111
1001N111
10101
11111
