
SO textures/South.xpm
WE textures/West.xpm
EA textures/East.xpm
NO textures/North.xpm
C 2,255,55
F 220,100,0


111111
11111111111
10000000001
10010000W01
10000000001
11111111111