SO textures/Prototype/West.xpm
WE textures/Prototype/West.xpm
EA textures/Prototype/East.xpm
NO textures/Prototype/North.xpm
C 250,55,55
F 220,100,0




11111111111
11111000001
100N1110011
10011111111
11111111111