



SO ./path_to_the_south_texture



WE ./path_to_the_west_texture
C 5,,500,10
F 220,10,0
EA ./path_to_the_east_texture


NO ./path_to_the_north_texture





111111
1001N111
10101
11001
11111
10001
11111

