SO textures/Prototype/South.xpm
WE textures/Prototype/West.xpm
EA textures/Prototype/East.xpm
NO textures/Prototype/North.xpm
C                                                 250,55,55
F 220,000,0

1   1   1111
11111111101
10000001011111
110N010011
10001 100011
111111111111


