SO oui
WE prout
EA ./path_to_the_east_texture
NO ./path_to_the_north_texture    
C                    250,55,55

F 220,100,0

11111111111
11111000001
100N1110011
11111111111